11111111111111
11000000C00E01
11P100000C0011
1100000C100001
10C10100010101
1010100C1C0001
11111111111111