11111111111111111111111
11000000C0000000E000101
11P100000C001C100000001
1100000C100001000010001
11111111111111111111111
