1111111
1100C11
110AE01
100P001
1111111
