11111111
100P1011
100E001
111111111
