1111111111111
1010101010101
1C100C00E01P1
1110001000001
1111111111111
